"filename", "language", "Java Properties", "Batch", "Groovy", "YAML", "Java", "comment", "blank", "total"
"e:\source\repos\WeaveCustomSchedule\bin\main\config.yml", "YAML", 0, 0, 0, 2, 0, 0, 0, 2
"e:\source\repos\WeaveCustomSchedule\bin\main\countdowns\eg_countdown.yml", "YAML", 0, 0, 0, 32, 0, 19, 3, 54
"e:\source\repos\WeaveCustomSchedule\bin\main\countdowns\eg_serverstart.yml", "YAML", 0, 0, 0, 28, 0, 6, 1, 35
"e:\source\repos\WeaveCustomSchedule\bin\main\lang\en_US.yml", "YAML", 0, 0, 0, 18, 0, 6, 3, 27
"e:\source\repos\WeaveCustomSchedule\bin\main\lang\zh_SC.yml", "YAML", 0, 0, 0, 17, 0, 5, 3, 25
"e:\source\repos\WeaveCustomSchedule\bin\main\plugin.yml", "YAML", 0, 0, 0, 11, 0, 0, 3, 14
"e:\source\repos\WeaveCustomSchedule\bin\main\schedules\eg_schedule.yml", "YAML", 0, 0, 0, 18, 0, 23, 2, 43
"e:\source\repos\WeaveCustomSchedule\build.gradle", "Groovy", 0, 0, 46, 0, 0, 0, 7, 53
"e:\source\repos\WeaveCustomSchedule\gradle.properties", "Java Properties", 0, 0, 0, 0, 0, 0, 1, 1
"e:\source\repos\WeaveCustomSchedule\gradle\wrapper\gradle-wrapper.properties", "Java Properties", 7, 0, 0, 0, 0, 0, 1, 8
"e:\source\repos\WeaveCustomSchedule\gradlew.bat", "Batch", 0, 41, 0, 0, 0, 30, 22, 93
"e:\source\repos\WeaveCustomSchedule\settings.gradle", "Groovy", 0, 0, 1, 0, 0, 0, 1, 2
"e:\source\repos\WeaveCustomSchedule\src\main\java\cn\yxgeneral\weavestudio\weavecustomschedule\WCSCommandHandler.java", "Java", 0, 0, 0, 0, 18, 0, 3, 21
"e:\source\repos\WeaveCustomSchedule\src\main\java\cn\yxgeneral\weavestudio\weavecustomschedule\WCSConfigManager.java", "Java", 0, 0, 0, 0, 60, 2, 6, 68
"e:\source\repos\WeaveCustomSchedule\src\main\java\cn\yxgeneral\weavestudio\weavecustomschedule\WCSCountdownNotifier.java", "Java", 0, 0, 0, 0, 80, 1, 5, 86
"e:\source\repos\WeaveCustomSchedule\src\main\java\cn\yxgeneral\weavestudio\weavecustomschedule\WCSCountdownObject.java", "Java", 0, 0, 0, 0, 78, 0, 6, 84
"e:\source\repos\WeaveCustomSchedule\src\main\java\cn\yxgeneral\weavestudio\weavecustomschedule\WCSEventHandler.java", "Java", 0, 0, 0, 0, 14, 0, 3, 17
"e:\source\repos\WeaveCustomSchedule\src\main\java\cn\yxgeneral\weavestudio\weavecustomschedule\WCSInteractiveExecutor.java", "Java", 0, 0, 0, 0, 18, 1, 3, 22
"e:\source\repos\WeaveCustomSchedule\src\main\java\cn\yxgeneral\weavestudio\weavecustomschedule\WCSPermission.java", "Java", 0, 0, 0, 0, 19, 0, 3, 22
"e:\source\repos\WeaveCustomSchedule\src\main\java\cn\yxgeneral\weavestudio\weavecustomschedule\WCSScheduleObject.java", "Java", 0, 0, 0, 0, 45, 0, 4, 49
"e:\source\repos\WeaveCustomSchedule\src\main\java\cn\yxgeneral\weavestudio\weavecustomschedule\WCSSingleCountdownEvent.java", "Java", 0, 0, 0, 0, 43, 0, 4, 47
"e:\source\repos\WeaveCustomSchedule\src\main\java\cn\yxgeneral\weavestudio\weavecustomschedule\WCSSingleScheduleEvent.java", "Java", 0, 0, 0, 0, 147, 1, 6, 154
"e:\source\repos\WeaveCustomSchedule\src\main\java\cn\yxgeneral\weavestudio\weavecustomschedule\WCSTableManager.java", "Java", 0, 0, 0, 0, 117, 2, 4, 123
"e:\source\repos\WeaveCustomSchedule\src\main\java\cn\yxgeneral\weavestudio\weavecustomschedule\WCSTimer.java", "Java", 0, 0, 0, 0, 77, 0, 5, 82
"e:\source\repos\WeaveCustomSchedule\src\main\java\cn\yxgeneral\weavestudio\weavecustomschedule\WeaveCustomSchedule.java", "Java", 0, 0, 0, 0, 41, 2, 4, 47
"e:\source\repos\WeaveCustomSchedule\src\main\resources\config.yml", "YAML", 0, 0, 0, 10, 0, 0, 1, 11
"e:\source\repos\WeaveCustomSchedule\src\main\resources\countdowns\eg_countdown.yml", "YAML", 0, 0, 0, 33, 0, 19, 3, 55
"e:\source\repos\WeaveCustomSchedule\src\main\resources\countdowns\eg_serverstart.yml", "YAML", 0, 0, 0, 28, 0, 6, 1, 35
"e:\source\repos\WeaveCustomSchedule\src\main\resources\lang\en_US.yml", "YAML", 0, 0, 0, 18, 0, 6, 3, 27
"e:\source\repos\WeaveCustomSchedule\src\main\resources\lang\zh_SC.yml", "YAML", 0, 0, 0, 17, 0, 5, 3, 25
"e:\source\repos\WeaveCustomSchedule\src\main\resources\plugin.yml", "YAML", 0, 0, 0, 11, 0, 0, 3, 14
"e:\source\repos\WeaveCustomSchedule\src\main\resources\schedules\eg_schedule.yml", "YAML", 0, 0, 0, 18, 0, 23, 2, 43
"Total", "-", 7, 41, 47, 261, 757, 157, 119, 1389